11111111111111111111111111111111111111111111111111111111111111
100100000000000000000000000000000000000000000010000000000000E1
10000111110010000C00C00000C00000000000111111111000000000001111
10C0000P000C0000000C00C000000000000000000000000000010000000001
10000111111001111C00000000C00000000000011111000C00010000000001
10000C000100000000000C0000000011111100010000000000000000C00001
1000000001C00000C000000C000000100011000100000000C0010000000001
100000000000000000000C0000111110001100010000C00000010000000001
100000000000C000000C00000000C00000010000000111110C010000C00001
10000000011110000111111110000001111100000001000C00000000000001
1000000001000000010000000000C000000000000001000000000000000001
1000000001000000000000C0000000000000011111110000C0000C00000001
100000000100000001000000000010000C0000000001000000000000000001
1000000001000000010000000000100000000000000100000CCC0000C00001
10000000010000000100000000001000000000000000000000000000000001
10000100000001000C00000000C00000000000011111000C00010000000001
10000111111001111C00000000C00000000000011111000C00010000000001
10000111111001111C00000000C00000000000011111000C00010000000001
10000111111001111C00000000C00000000000011111000C00010000000001
10000111111001111C000S0000C00000000000011111000C0S010000000001
10000111111001111C00000000C00000000000011111000C00010000000001
10000111111001111C00000000C00000000000011111000C00010000000001
10000111111001111C00000000C00000000000011111000C00010000000001
10000111111001111C00000000C00000000000011111000C00010000000001
11111111111111111111111111111111111111111111111111111111111111
