11111111111111111111111111111111111111
1E0000000000000C00000C0000000S00000001
10100100S01000001010010000000000010101
10100100001010100010000001000000010101
1P0000000C00C00000000000000000000000C1
11111111111111111111111111111111111111
